NO ./src/image/nord.xpm

R 500 500

SO ./src/image/sud.xpm

WE ./src/image/ouest.xpm

EA ./src/image/est.xpm


S ./src/image/sprite.xpm


F  128,128,128


C  255,255,255


11111111
10000001
10000E01
11111111