NO ./src/image/nord.xpm

R 600 600

SO ./src/image/sud.xpm

WE ./src/image/ouest.xpm

EA ./src/image/est.xpm


S ./src/image/sprite.xpm


F  128,128,128


C  250,250,250


1 1 1 1 1 1 1 1 1 1 1 1 1 1 1 1 1
1 1 1 1 1 1 1 1 1 1 1 1 1 1 1 1 1
1 1 0 0 0 0 0 0 0 0 0 0 0 0 0 1 1
1 1 0 0 0 0 0 0 0 0 0 0 0 0 0 1 1
1 1 0 0 0 1 0 0 0 0 0 0 0 0 0 1 1
1 1 0 0 0 0 0 0 0 0 0 0 0 0 0 0 1
1 0 0 0 0 0 0 0 0 0 0 0 0 0 0 0 1
1 0 0 0 0 0 0 0 0 0 0 0 2 0 0 1 1
1 0 0 0 0 0 0 0 0 0 0 0 0 0 0 0 1
1 1 0 0 0 0 0 0 0 0 0 0 0 0 0 0 1
1 1 0 0 0 0 0 0 0 1 0 0 E 0 0 1 1
1 1 0 0 0 1 0 0 0 0 0 0 0 0 0 1 1
1 1 0 0 0 0 0 0 0 0 0 0 0 0 0 1 1
1 1 0 0 0 0 0 0 0 0 0 0 0 0 0 1 1
1 1 0 0 0 0 0 0 0 0 0 0 0 0 0 1 1
1 1 0 0 0 0 0 0 1 0 1 0 0 0 0 1 1
1 1 0 0 0 0 0 0 1 0 1 0 0 0 0 1 1
1 1 0 0 0 0 0 0 1 0 1 0 0 0 0 1 1
1 1 0 0 0 0 0 0 0 1 0 0 0 0 0 1 1
1 1 1 1 1 1 1 1 1 1 1 1 1 1 1 1 1
1 1 1 1 1 1 1 1 1 1 1 1 1 1 1 1 1
